1
10 15
|||....||.|||.|
|||.||.|......|
|||.||........|
|||.||||..|||.|
|F|.|...||....|
|.|.|.||......|
|.....||||....|
|.||||||......|
|....|..|||||S|
||||....|||||.|