1
10 10
|||....|||
|||.||.|.F
|||.||...|
|||.||||||
|S|.|....|
|.|.|.||.|
|.|...||.|
|.||||||.|
|....|...|
||||...|||
